ARE	AA R
ARE(2)	ER
BACKWARD	B AE K W ER D
DOING	D UW IH NG
EVA	EY V AH
EVA(2)	IY V AH
FORWARD	F AO R W ER D
FOUR	F AO R
GO	G OW
HEY	HH EY
HOW	HH AW
IS	IH Z
LEFT	L EH F T
LOCATION	L OW K EY SH AH N
ME	M IY
MOVE	M UW V
MY	M AY
ONE	W AH N
ONE(2)	HH W AH N
RIGHT	R AY T
START	S T AA R T
STOP	S T AA P
TAKE	T EY K
THE	DH AH
THREE	TH R IY
TIME	T AY M
TO(2)	T IH
TO(3)	T AH
TWO	T UW
WHAT	W AH T
WHAT(2)	HH W AH T
YOU	Y UW
